5
..###
....#
###.#
#....
###..
9
..#######
....#...#
#.###.###
#.......#
#.###.#.#
#.#...#.#
#.#.###.#
#.#.#...#
#######..
9
..#######
....#...#
#.###.###
#.......#
#.###.#.#
#.#...###
#.#.###.#
#.#.#...#
#######..